1111111111
1000000001
1000011001
10E0000001
10P000C001
1000E00001
1111111111