11111111111111111111111111111111111111111111
100000000C0010001CCCCC0000000000000010000001
100000000C000000CCCCC00000000000000000000011
10CC000000000001111000000CCCC0000000000C0001
100000000000CC000000CC0000001100000000000001
100000CCC00P011CCC0000CC00000000011000000001
1000CCCC00000000000000000CCC00000000000000E1
1E000000000000000000CC0000000000000000000001
11111111111111111111111111111111111111111111